browers	browser
asigned	assigned
hanlde	handle
poining	pointing
pittsburg	pittsburgh
inequlity	inequality
exeption	exception
soem	some
meagniful	meaningful
securiy	security
meassure	measure
dessa	essa
buiild	build
aproach	approach
oldeer	older
aroung	around
repsond	respond
explicliy	explicitly
tranlate	translate
khói	khỏi
embedeed	embedded
wriitten	written
defailt	default
kenrel	kernel
adventage	advantage
validater	validator
initilise	initialize
conise	concise
stephan	stephen
persitant	persistent
evalution	evaluation
rysnc	rsync
githuhb	github
locgical	logical
rhe	the
grenlets	greenlets
fultiple	multiple
broswers	browsers
succssful	successful
legen	legend
unknwon	unknown
alson	also
availible	available
fromm	from
raiils	rails
namespece	namespace
hesistate	hesitate
packege	package
associted	associated
provion	provision
listenning	listening
hieght	height
developped	developed
chosed	chosen
sepcify	specify
pareuet	parquet
maxiumum	maximum
uma	um
gutengerb	gutenberg
scss	css
candidated	candidate
silumar	simular
cunn	cudnn
sofware	software
syndrom	syndrome
leidal	leidel
visusal	visual
pylplt	pyplot
appl	app
versiom	version
folllowing	following
txsockxs	txsocks
apllies	applies
lin	line
opperating	operating
dilligence	diligence
joine	joined
dien	dein
cahce	cache
cann	can
redirec	redirect
standerd	standard
numbrer	number
guthub	github
repnz	repe
incease	increase
repayed	repaid
componets	components
referennce	reference
masskew	maxskew
divder	divider
listern	listener
keword	keyword
exeucting	executing
hallowwing	hallowing
hoook	hook
rin	run
impoort	import
depened	depend
goood	good
